BBBBBBBBBBBBB
B           B
B BBB BBaBB B
B B B B   B B
B B B B BBB B
B   B B B   B
BBBBB B B B B
B       B B B
B B BBB B B B
B B   B B B B
B BBBBB BBp B
B           B
BBBBBBBBBBBBB