BBBBBBBBBBBBBBB
B B           B
B B B BBB BBB B
B B B B   B B B
B B BaBBBBB B B
B B B       B B
B B B BBB BBB B
B B B B B B   B
B B BBB BBB B B
B        p  B B
BBBBBBBBBBBBBBB