BBBBBBBBBBBBBBBBB
B               B
B BBBBB BBBBBBB B
B B     B     B B
B BaB B BBB B B B
B B B B   B   B B
B B B BBB BBB B B
B B     B   B B B
B BBBBB BBBBB B B
B     B p     B B
BBBBB BBBBBBBBB B
B               B
BBBBBBBBBBBBBBBBB