BBBBBBBBBBBBBBBBB
B               B
B BBB BBBBB BBB B
B B B B   B   B B
B B BaBBB BBB B B
B       B   B B B
B BBBBB BBB B B B
B B       B B B B
B B BBBBBBB B B B
B B B       B B B
B B B BBB BBB B B
B B B   B B Bp  B
B BBB BBBBB BBB B
B               B
BBBBBBBBBBBBBBBBB