BBBBBBBBBBBBBBB
B             B
B B BBBBBBB B B
B B B     B B B
B BBB B BBB B B
B     B B     B
B aBBBB B BBB B
B B       B B B
B BBBBBBpBB B B
B             B
BBBBBBBBBBBBBBB