BBBBBBBBBBBBBBB
B             B
B B BBB B BBB B
B B B B B B B B
B B B B B a BBB
B B B B   B   B
B B B BBB BBB B
B B B   B   B B
B B BBB B BBB B
B B     B B   B
B BBBBBBB BBB B
B        p    B
BBBBBBBBBBBBBBB