BBBBBBBBBBBBBBBBBBBBBBB
BaB     B BB    B   B B
B   B B B    B BB B B B
B BBB BBB BBBB BB B B B
B   B     BB      B   B
B B B BBB BB B BBBB B B
B B B B   B  B   BB B B
B  B  B B B BB B B  B B
B B B   B B B  B B BB B
B     B B   B BB B BBpB
BBBBBBBBBBBBBBBBBBBBBBB